+      +------+------+------+
|             |             |
|             |             |
+------+      +      +      +
|             |      |      |
|             |      |      |
+      +------+      +      +
|                    |      |
|                    |      |
+------+------+------+------+
