+   +---+---+---+---+
|               |   |
+---+   +   +   +---+
|   |   |   |   |   |
+   +   +   +   +---+
|               |   |
+---+---+---+---+---+
|   |   |   |   |   |
+---+---+---+---+---+
|   |   |   |   |   |
+---+---+---+---+---+

