+   +---+---+---+---+
|   |   |   |   |   |
+   +---+---+---+---+
|               |   |
+               +---+
|               |   |
+---+---+---+---+---+
|   |   |   |   |   |
+---+---+---+---+---+
|   |   |   |   |   |
+---+---+---+---+---+
