+   +---+---+---+---+
|               |   |
+---+---+---+   +---+
|               |   |
+   +---+---+   +---+
|               |   |
+---+---+---+---+---+
|   |   |   |   |   |
+---+---+---+---+---+
|   |   |   |   |   |
+---+---+---+---+---+
