+   +---+---+---+
|   |   |   |   |
+   +---+---+   +
|           |   |
+---+       +---+
|   |       |   |
+---+---+---+---+
|   |   |   |   |
+---+---+---+---+

